11111111111111111111111
1P0000100001110000000C1
10000000100001C00000111
10001100100001110000001
10000100000000000000001
10001C00000110000000001
1S0011000000100000001E1
11111111111111111111111