1111111111111111111111111111111
1P000000001000000001110000000C1
10000000001000000001C0000000111
1000001100100000000111000000001
1000000100000000000000000000001
1000001C00000000011000000000001
1S000011000000000010000000001E1
1111111111111111111111111111111