1111111111111111
1P01000000000001
1001001001001001
1000C01001001001
1001001111001001
1S01000001001001
1111001111111001
1000001000000S01
1001111111001001
10000000010010E1
1111111111111111