1111111111111111111
1P000000000000000C1
1000000000000000001
10000S00000000C0001
1000000000000000001
10000000C0000000001
1000000000000000001
10000000000000C0001
100C000000000000001
1000000000000000001
1000000000000000001
1000000000000S00001
1000C00000000000001
1000000000000000001
10000000000000000S1
10000000C0000000001
1000000000000000001
1S000000000000000E1
1111111111111111111