1111111111111111111111
1P00000001000000000001
1001111111001001111001
1001C01C000010010C1001
1001001111111001001001
10010000000000000010C1
1001111001111111001111
1000000001C01000000001
1001001001001001001001
1S01001001000001001001
1111001001001111001001
1C01001C01001000001001
1001111111111001111001
10000000000000010000E1
1111111111111111111111